NO ./src/texture/bangboo1.xpm
SO ./src/texture/bangboo2.xpm
WE ./src/texture/bangboo3.xpm
EA ./src/texture/bangboo4.xpm

C 20,20,20
F 10,10,10

111   111
1N1   101
1111 1111
   1 1
1111 1111
101   101
111   111
