NO ./src/texture/bangboo1.xpm
SO ./src/texture/bangboo2.xpm
WE ./src/texture/bangboo3.xpm
EA ./src/texture/bangboo4.xpm

C 20,20,20
F 10,10,10

1
 11111111
 1000N001
 11111111
         1
