NO ./src/texture/bangboo1.xpm
SO ./src/texture/bangboo2.xpm
WE ./src/texture/bangboo3.xpm
EA ./src/texture/bangboo4.xpm
F 10,10,10
C 20,20,20


11111
1N001
10S01
11111
