NO ./src/texture/bangboo1.xpm
SO ./src/texture/bangboo2.xpm
WE ./src/texture/bangboo3.xpm
EA ./src/texture/bangboo4.xpm

C 20,20,20
F 10,10,10

11111
1N001
10001
11111      11
11111
10001      11
10001
11111
