NO ./src/texture/bangboo1.xpm
SO ./src/texture/bangboo2.xpm
WE ./src/texture/bangboo3.xpm
EA ./src/texture/bangboo4.xpm


F 251,,,,,20,20
C 10,10,10

1111111
11011
10N01
1111111
111111111
10001
10001
11101
  111












