NO ./src/texture/bangboo1.xpm
SO ./src/texture/bangboo2.xpm


C 220,100,0
WE ./src/texture/bangboo3.xpm
EA ./src/texture/bangboo4.xpm
F 225,30,0



        1111111111111111111111111
        1E00000000110000000000001
        1011000001110000000000001
111111111000000000000000111111111
111111111011000001110000000000001
100000000011000001111111111111111
11111111111111011100000010001
11110111111111011101010010001
11000000110101011100000010001
10000000000000001100000010001
10000000000000001101010010001
1100000111010101111101111000111
11110111 1110101 101111010001
11111111 1111111 111111111111





